aaa	lys
aac	asn
aag	lys
aat	asn
aca	thr
acc	thr
acg	thr
act	thr
aga	arg
agc	ser
agg	arg
agt	ser
ata	ile
atc	ile
atg	met
att	ile
caa	gln
cac	his
cag	gln
cat	his
cca	pro
ccc	pro
ccg	pro
cct	pro
cga	arg
cgc	arg
cgg	arg
cgt	arg
cta	leu
ctc	leu
ctg	leu
ctt	leu
gaa	glu
gac	asp
gag	glu
gat	asp
gca	ala
gcc	ala
gcg	ala
gct	ala
gga	gly
ggc	gly
ggg	gly
ggt	gly
gta	val
gtc	val
gtg	val
gtt	val
taa	stp
tac	tyr
tag	stp
tat	tyr
tca	ser
tcc	ser
tcg	ser
tct	ser
tga	stp
tgc	cys
tgg	trp
tgt	cys
tta	leu
ttc	phe
ttg	leu
ttt	phe
